10 10
4 5
1111111111
0000110001
1000000011
1000001111
1100000001
1110000001
1111000101
1000000001
1111101011
1111011111